111111111111111111111
100000000000000000001
100000000000000000001
100000000001000000001
100000000001000000001
100000000001000000001
100000000000000000001
100000000000000000001
100000P00000000000001
100000000000000000001
100000000000000000001
100000000111100000001
100000000000000000001
100000000000000000001
100000000000000000001
111111111111111111111
